NO ./textures/n_wall.xpm
SO ./textures/e_wall.xpm
WE ./textures/s_wall.xpm
EA ./textures/w_wall.xpm

F 220,100,0
C 225,30,0

11111111111111111111111111
 1000000000110000000000001
 1011000001110000000000001
 1001000000000000000000001
111111111011000001110000111111111
100010000011000001110111111111111
111101111111110111000000100011
1111011111111101 1101010010001
110000001101010111000000100011
10000000000000001100000010001
10000000000000011010100100111
110010011101010111110110N0111
11110111 1110101 101111010011111
11111111 11b1111 111111111111