NO ./textures/gravel.xpm
SO ./textures/redpattern.xpm
WE ./textures/hierba.xpm
EA ./textures/yelltexpattern.xpm


F 102,0,51
C 102,178,225


111111111111111111111111111
1001110000110000000000001
1011000001110000000000001
1001000000000000000000001
111111111011000001110000111111111
100000000011000001110111111111111
111101111111110111000000100011
1111011111111101 1101010100001
110000001101010111000000100011
10000000000000001100000010001
10000000000000011010100000111
110010011101010111110110N0111
11110111 1110101 101111010011111
11111111 1111111 111111111111
